11111111111
10000100001
10PC0100001
1000C100001
11110C01111
100001C0001
1000010C001
10000100E01
10000100001
11111111111
