11111111111111111111111
1P100000G0010C000010001
101C111000001110G010C01
101010010C0000010010001
1C1010C0000GC001G010001
101010G00C00000100C1001
1G1010C00G00C0010110101
10101111011111010100001
101C0001010G0001000G001
10111101010C011100C0001
10C00G000100000C00G00E1
11111111111111111111111
