1111111111111
111C01110C111
110G00100G011
100000P000001
1C000000000C1
11000G0G00011
111G00000G111
1111000001111
11111C0C11111
111111E111111
1111111111111
1111111111111
