11111111111
11111010001
10000000101
10111110101
101E1P10101
10001010101
10101010101
10001000000
11111111111
