111111111
100P00001
100000001
1000000C1
100010011
100000001
10EC0C001
111111111
