1111111111111111
1P00000000000011
1010101010101011
1C1010101C010101
1000000000000001
1000000000000001
100000000E000001
1000000000000001
100000000C000001
1000000000000001
1CCC000000000001
1000000000000001
1111111111111111
