111111111111111
1100P00001C0E01
100000000100001
1001110C0110111
100000000000001
11110C0000C0001
10C100000001111
10000000C111001
100CCC000000001
111111111111111
