1111111111
1P0000C001
1000C00G01
10C00G00E1
1111111111
